00001000
00002043
00004302
00065000
00006000
00005000
00000000
01000000